++++++++++++++++++++++++++++
+.......+.......+.......+...
+++++.+.+.+++++.+.+.+++.+.++
+.....+.+...+...+.+.+.+.+...
+.+++++.+++.+.+++++.+.+.+++.
+.+.......+.+.....+.+.+.....
+.+.+++++++.+++++.+.+.+++++.
+.+.+.........+...+.+...+.+.
+.+.+.+++++++++.+++.+.+.+.+.
+.+.+.+...+...+.+...+.+...+.
+.+.+p+.+.+.+.+.+++.+.+++++.
+.+.+.+.+.+.+.+.+...+.......
+.+.+.+.+.+.+++p+.+.+++++.++
+.+.+...+.+.+...+.+.+...+...
+.+++++++.+.hhhh+.+++.+p+++.
+...+.....+...+...+...+.+...
+++.+.+++++++++.+.+.+++.++++
+...+.....+.....+.+.+.+.+...
+.+++++++.+.+.+++++.+.+.+.+.
+.......+.+.+.........+...+.
+++++.+.+.+++++++++.+++++++.
+.....+.+.........+.+.......
+.+++.+++++++++++.+++.+++++.
+.+...+.....+.....+...+.....
+.+++.+.+++.+.+++++.+++.++++
+...+.+...+...+.....+...+...
+.+.+.+++.+++++++.+++.+++++.
+.+.+...+.........+.+...+...
+.+.+++++++++++++++.+++.+.+.
+.+.......................+.
++++++++++++++++++++++++++++
